google	nam	us	i
microsoft	nam	us	i
fb	nam	us	i
cmu	nam	us	a
deepmind	eur	gb	i
industry	unk	unk	unk
mit	nam	us	a
stanford	nam	us	a
ucb	nam	us	a
cas	asi	cn	a
amazon	nam	us	i
tsinghua	asi	cn	a
tencent	asi	cn	i
allenai	nam	us	i
cuhk	asi	hk	a
cambridge	eur	gb	a
uw	nam	us	a
cornell	nam	us	a
edinburgh	eur	gb	a
uiuc	nam	us	a
gatech	nam	us	a
utoronto	nam	ca	a
amsterdam	eur	nl	a
ethz	eur	ch	a
nyu	nam	us	a
ibm	nam	us	i
nvidia	nam	us	i
upenn	nam	us	a
peking	asi	cn	a
jhu	nam	us	a
hkust	asi	hk	a
epfl	eur	ch	a
openai	nam	us	i
alibaba	asi	cn	i
ucla	nam	us	a
ucl	eur	gb	a
bristol	eur	gb	a
adobe	nam	us	i
inria	eur	fr	a
ucsd	nam	us	a
utexas	nam	us	a
columbia	nam	us	a
nus	asi	sg	a
umass	nam	us	a
mpi	eur	de	a
umd	nam	us	a
oxford	eur	gb	a
umich	nam	us	a
umontreal	nam	ca	a
ntu	asi	sg	a
jd	asi	cn	i
utokyo	asi	jp	a
tum	eur	de	a
apple	nam	us	i
imperial	eur	gb	a
fudan	asi	cn	a
nanjing	asi	cn	a
hit	asi	cn	a
stonybrook	nam	us	a
usc	nam	us	a
unc	nam	us	a
usyd	ocn	au	a
huawei	asi	cn	i
unimelb	ocn	au	a
cnrs	eur	fr	a
qcri	mea	qa	a
ttic	nam	us	a
kyoto	asi	jp	a
monash	ocn	au	a
unsw	ocn	au	a
sfu	nam	us	a
zhejiang	asi	cn	a
tu darmstadt	eur	de	a
technion	mea	il	a
weizmann	mea	il	a
soochow	asi	cn	a
msu	nam	us	a
princeton	nam	us	a
neu	nam	us	a
mcgill	nam	us	a
kaist	asi	kr	a
korea	asi	kr	a
yonsei	asi	kr	a
rutgers	nam	us	a
cvut	eur	cz	a
boston	nam	us	a
uwaterloo	nam	ca	a
tau	mea	il	a
smu	asi	sg	a
sheffield	eur	gb	a
glasgow	eur	gb	a
purdue	nam	us	a
sysu	asi	cn	a
uci	nam	us	a
snu	asi	kr	a
heidelberg	eur	de	a
twu	asi	tw	a
nctu	asi	tw	a
saarland	eur	de	a
hust	asi	cn	a
huji	mea	il	a
tamu	nam	us	a
bloomberg	nam	us	i
beihang	asi	cn	a
kth	eur	se	a
westlake	asi	cn	a
ustc	asi	cn	a
umn	nam	us	a
hkpu	asi	hk	a
stuttgart	eur	de	a
samsung	asi	kr	i
salesforce	nam	us	i
qmul	eur	gb	a
kaust	mea	sa	a
ruc	asi	cn	a
polymtl	nam	ca	a
tianjin	asi	cn	a
bupt	asi	cn	a
bonn	eur	gb	a
osaka	asi	jp	a
riken	asi	jp	a
njust	asi	cn	a
hw	eur	gb	a
sensetime	asi	cn	i
uic	nam	us	a
virginia	nam	us	a
baidu	asi	cn	i
copenhagen	eur	dk	a
arizona	nam	us	a
hku	asi	hk	a
upc	eur	es	a
unimore	eur	it	a
polimi	eur	it	a
zurich	eur	ch	a
trento	eur	it	a
upv	eur	es	a
uts	ocn	au	a
surrey	eur	gb	a
colorado	nam	us	a
twitter	nam	us	i
tu berlin	eur	de	a
tohoku	asi	jp	a
queensland	ocn	au	a
adelaide	ocn	au	a
rwth	eur	de	a
seu	asi	cn	a
yale	nam	us	a
vt	nam	us	a
bit	asi	cn	a
biu	mea	il	a
xidian	asi	cn	a
ubc	nam	ca	a
sjtu	asi	cn	a
kul	eur	be	a
asu	nam	us	a
wisc	nam	us	a
laval	nam	ca	a
freiburg	eur	de	a
psu	nam	us	a
oregonstate	nam	us	a
nict	asi	jp	a
mbzuai	mea	ae	a
infocomm	asi	sg	a
itu	eur	dk	a
meituan	asi	cn	i
uniroma	eur	it	a
fbk	eur	it	a
duke	nam	us	a
dcu	eur	ie	a
waymo	nam	us	i
lmu	eur	de	a
cardiff	eur	gb	a
bytedance	asi	cn	i
anu	ocn	au	a
utah	nam	us	a
macau	asi	mo	a
iit	asi	in	a
mannheim	eur	de	a
ualberta	nam	ca	a
sutd	asi	sg	a
ucf	nam	us	a
dartmouth	nam	us	a
buffalo	nam	us	a
xiamen	asi	cn	a
wpi	nam	us	a
wvu	nam	us	a
vu amsterdam	eur	nl	a
tudelft	eur	nl	a
utrecht	eur	nl	a
vienna	eur	at	a
ottawa	nam	ca	a
uoregon	nam	us	a
helsinki	eur	fi	a
aalto	eur	fi	a
uchicago	nam	us	a
ucsb	nam	us	a
birmingham	eur	gb	a
udc	eur	es	a
ud	nam	us	a
tu graz	eur	at	a
sorbonne	eur	fr	a
shandong	asi	cn	a
nec	nam	us	a
rochester	nam	us	a
siemens	eur	de	i
qut	ocn	au	a
queens	nam	ca	a
naver	eur	fr	a
xjtu	asi	cn	a
warwick	eur	gb	a
ucmerced	nam	us	a
titech	asi	jp	a
liverpool	eur	gb	a
nankai	asi	cn	a
lund	eur	se	a
athens	eur	gr	a
manchester	eur	gb	a
leeds	eur	gb	a
york	nam	ca	a
macquarie	ocn	au	a
linköping	eur	se	a
utdallas	nam	us	a
stavanger	eur	no	a
uestc	asi	cn	a
temple	nam	us	a
iowa	nam	us	a
gw	nam	us	a
cnam	eur	fr	a
uniweimar	eur	de	a
oulu	eur	fi	a
uppsala	eur	se	a
hamburg	eur	de	a
postech	asi	kr	a
polito	eur	it	a
paderborn	eur	de	a
northwestern	nam	us	a
nui	eur	ie	a
leipzig	eur	de	a
kcl	eur	gb	a
jilin	asi	cn	a
intel	nam	us	i
ulisboa	eur	pt	a
jku	eur	at	a
iitd	asi	in	a
iisc	asi	in	a
idsia	eur	ch	a
bern	eur	ch	a
hpi	eur	de	a
harvard	nam	us	a
georgetown	nam	us	a
dfki	eur	de	a
dalian	asi	cn	a
uab	nam	us	a
caltech	nam	us	a
brown	nam	us	a
bocconi	eur	it	a
wuhan	asi	cn	a
unm	nam	us	a
cityu	asi	hk	a
houston	nam	us	a
tilburg	eur	nl	a
ucsc	nam	us	a
iiit	asi	in	a
hec montréal	nam	ca	a
crete	eur	gr	a
osu	nam	us	a
aist	asi	jp	a
wustl	nam	us	a
pitt	nam	us	a
ucdavis	nam	us	a
malaya	asi	my	a
rmit	ocn	au	a
wa	ocn	au	a
kit	eur	de	a
emory	nam	us	a
rice	nam	us	a
iu	nam	us	a
shanghaitech	asi	cn	a
uta	nam	us	a